11111111111111111111111111111
1000C000000000000011111111111
10000000000000000000001111111
10000001111111110000000000001
1000000000000000000100000I001
10000000000000C0000000000EI01
1111110000000111000100000I001
10000011111100000000000000001
100P0000000000011110000000001
11111111111111111111111111111