11111111111111111111111111111
1000C000000000000011111111111
10000000000000000000001111111
10000001111111110000000000001
100000000000C000000100I000001
1000000000000000000000000E001
1111110000000111000100I000001
11111100000000000000000000001
100P000000000001111000000I001
11111111111111111111111111111