11111111111111111111111111111
1000C000000000000011111111111
10000000000000000000001111111
10000001111111110000000000001
100000000000C000000100I000001
1000000000000000000000000E001
11111100000001110001000000001
11111100000000000000000000001
100P0000000000011110000000001
11111111111111111111111111111