111111111111111111111111111111111111111111
1IP000000000000000C000000000000000000000E1
111111111111111111111111111111111111111111