11111111111111111111111111111
1CCCCCCCCCCCCCCCCC11111111111
1CCCCCCCCCCCCCCCCCCCCC1111111
1CCCCCC111111111CCCCCCCCCCCC1
1CCCCCCCCCCCCCCCCCC1CCCCCCCC1
1CCCCCCCCCCCCCCCCCCCCCCCCECC1
111111CCCCCCC111CCC1CCCCCCCC1
111111CCCCCCCCCCCCCCCCCCCCCC1
1ICCCCPCCCCCCCC1111CCCCCCCCC1
11111111111111111111111111111
