111111111111111111111111111111111
1000000001000C1000000101010111C01
1C100101011011C100I1010000011C101
1111C101001000100010010C01I010101
1000110100010000P00000101000101C1
1C1001001010101000100100010010101
1C10000000000C1100100000C00000001
1C1C10010C10000110000100011001011
1E1111C00000110C110C11C01111000C1
111111111111111111111111111111111