111111111111111111111111111111111111111111
1P0000000000000000C0000000000000000I0000E1
111111111111111111111111111111111111111111